rodrigo carne: mostra imagem de carne
rodrigo portatil:appears to have extreme PTSD and starts convulsing on the floor
rodrigo guilherme: O guilherme é o melhor admin deste regime fascista ao qual chamamos discord
rodrigo autista: touches face until it starts to bleed
rodrigo retardado: face twitches and begins to form a crooked smile(edited)
rodrigo remember pedro: imagem de bons tempos
rodrigo amigos: Eu tenho bastantes amigos a quem eu dou a mão
rodrigo hack: Não compreendo. As pessoas que hackeiam chamam-se hackers?
rodrigo teclado: starts screaming and hitting his head on the wall
-----------------------------------------(edited)
MEMES MAKER(edited)
rodrigo truth mensagem: meme do scroll of truth(edited)
rodrigo safe mensagem: meme do nigga a apontar de do na testa
rodrigo drake mensagem;mensagem2: meme do drake
rodrigo facts mensagem: meme do edd a segurar um livro(edited)
rodrigo button mensagem: meme do nut button com a mensagem(edited)
rodrigo choice mensagem;mensagem2: meme do sweaty boy a decidir entre dois botoes
rodrigo marioluigi mensagem;mensagem2;mensagem3: meme das views do mario e luigi
rodrigo pikachu [mensagens]: meme do surprised pikachu (podem meter o numero de linhas que quiserem separadas por ; )(edited)
-----------------------------------------
UTILS
rodrigo vai brincar mensagem: muda a atividade do rodrigo para "Playing mensagem"
rodrigo vai jogar mensagem: muda a atividade do rodrigo para "Playing mensagem"(edited)
rodrigo vai ouvir mensagem: muda a atividade do rodrigo para "Listening to mensagem"
rodirigo vai ver mensagem: muda a atividade do rodrigo para "Watching mensagem"(edited)
rodrigo define mensagem: devolve a definicao dessa palavra no urban dictionary
rodrigo procura mensagem: devolve os 4 primeiros resultados do google para essa palavra(edited)
rodrigo probabilidade mensagem: Cerca de {random number}%
rodrigo clever mensagem: usa a api do cleverbot para responder (its shit)
rodrigo mensagem?: responde sim ou nao (AI extremamente avançada, proceed with caution)
rodrigo piada: devolve uma piada do subreddit jokes (dad jokes kinda)
rodrigo crypto {nome da moeda}: devolve a informacao da moeda em questao
rodrigo reddit {subreddit}: devolve um random post dos 1000 mais hot
rodrigo gif: devolve um gif do subreddit gif
rodrigo video: devolve um video do subreddit videos
rodrigo meme: devolve um meme dos subreddits 2meirl4meirl+boottoobig+dankmemes+greentext+insanepeoplefacebook+oldpeoplefacebook+memes+meme+imgoingtohellforthis+prequelmemes
rodrigo pornstar: devolve um post dos subreddits AvaAddams+Ava_Addams+RileyReid+Riley_Reid+RemyLaCroix+Remy_Lacroix+JadaStevens+BrandiLove+Melissamoore
rodrigo porn: devolve um post dos subreddits pornvids+porninfifteenseconds+nsfwhardcore+lesbians+grool+quiver+porn_gifs
rodrigo titty: devolve um post dos subreddits tessafowler+SexyFlowerWater+gonewild+NSFW_GIF+nsfw+BustyPetite+milf+OnOff+TittyDrop+LegalTeens+suicidegirls+boobbounce
rodrigo pussy: devolve um post dos subreddits ass+pawg+gettingherselfoff+asstastic+thick+GodPussy+BonerAlert+StraightGirlsPlaying+workgonewild+rearpussy+gwcumsluts+pussy+facedownassup+cumonclothes+jilling
rodrigo soft: devolve um post dos subreddits collegesluts+girlsinyogapants+FestivalSluts+tightdresses+randomsexiness+burstingout
rodrigo youtube {nome do canal}: devolve o ultimo video do canal(edited)
rodrigo twitch {nome do streamer}: devolve o stream do streamer (TENHO DE MELHORAR TÁ SHIT) e muda a atividade do rodrigo para "Watching {streamer}"(edited)
:rodrigo: : "Que carinha laroca!"
rodrigo good | nice | bem | bom | best | grande: "Durante a minha existência já gostaram de mim {numero de likes} vezes. I can't handle it!!! touches face violently"
rodrigo bad | mal | mau | worst | lixo: "Durante a minha existência já me deram bullying {numero de dislikes} vezes. Vou chamar os meus pais. cries while getting hit with a laptop"